10 10

1 1 1 1 1 1 1 1 1 1
1 0 0 0 1 0 0 0 0 1
1 0 P 0 1 0 0 0 0 1
1 S 0 M 1 0 0 0 0 1
1 0 0 0 0 0 0 0 0 1
1 0 0 0 0 0 0 0 0 1
1 0 0 0 0 0 0 0 0 1
1 0 0 0 0 0 0 0 0 1
1 0 0 0 0 0 0 0 0 1
1 1 1 1 1 1 1 1 1 1
